R 1200 1000
NO textures/bluestone.xpm
SO textures/mossy.xpm
WE textures/wood.xpm
EA textures/colorstone.xpm
S textures/purplestone.xpm
F 10,0,50
C 120,130,40

1111111111111
1020000010001
1000N00010021
1000000000001
1000200010001
1000000010001
1020020102001
1111111111111
