R 1000 1000
NO textures/bluestone.xpm
SO textures/mossy.xpm
WE textures/wood.xpm
EA textures/colorstone.xpm
S textures/purplestone.xpm
F 100,0,50
C 120,130,40

11111111
1N000001
10000001
10000001
10000001
10000001
10000001
11111111
