R 1200 1000
NO textures/bluestone.xpm
SO textures/mossy.xpm
WE textures/wood.xpm
EA textures/colorstone.xpm
S textures/krika.xpm
F 10,0,50
C 120,130,40




1111111111111
100000000001
100000W01001
100000200001
120000010011
1000000010001
100002000001
1111111111111



