R 1920 1080

NO ./path_to_the_north_texture
SO ./path_to_the_south_texture
WE ./path_to_the_west_texture
EA ./path_to_the_east_texture
S ./path_to_the_sprite_texture

F 222,32,34
C 14,54,154

111111111111111111111111
100000000000000000000001
100000000000000000000001
100000000000000000000001
100000000000000000000001
100000000000000000000001
100000000000000000000001
100000000000000000000001
1000000000000000000000011111
1100000000000000000000001
1000000000000000000000011111
100000000000000000000001
100000000000000000000001
100000000000000000000011
10000000000001100000000001
1000000000001 10000000111
100000000000011000000001
100000000000000000000001
100000000000000000000001
100000000000000000000001
100000000000000000000001
100000000000000000000001
100000000000000100000001
111111111111111 111111111