R 1920 1024
NO textures/rsz_moldura.xpm
SO textures/use_paws.xpm
WE textures/rsz_bonesblack.xpm
EA textures/rsz_boneswhite.xpm
S textures/kika_sprite.xpm
F 10,25,50
C 120,130,40


111111111111
100000000001
100000002001
100000000001
100000001001
100200000001
10000S00100011
1000000010001
1000000000001
1111111111111
